000000000000000000000000
000000000000000000000000
000040000000000000004000
000000000000000000000000
000000001111111000000000
000000001002001000000000
000000001030301000000000
000000001111111000000000
000000000000000000004000
000040000000000000000000
000000000000040000000000
000000000000000000000000
