000000000000000000000000
000000000000000000000000
000000000000000000000000
000000011111111100000000
000000010000000100000000
000000010032300100000000
000000010032300100000000
000000010000000100000000
000000011111111100000000
000000000000000000000000
000000000000000000000000
000000000000000000000000
